{
  "level": 1,
  "grid": [
    [6,0,0,0,0,0,0,0,0,0,0,0,0,0,0,0,0,0,0,0,0,0,0,0,0,0,0,0],
    [6,0,0,0,0,0,0,0,0,0,0,0,0,0,0,0,0,0,0,0,0,0,0,0,0,0,0,0],
    [6,0,0,0,0,0,0,0,0,0,0,0,0,0,0,0,0,0,0,0,0,0,0,0,0,0,0,0],
    [0,1,1,1,1,1,3,1,1,1,1,1,0,1,1,1,1,1,3,1,1,1,1,1,1,1,1,0],
    [0,0,0,5,0,0,3,0,0,0,5,0,0,0,0,0,5,0,3,0,0,0,0,0,0,0,0,0],
    [1,1,1,1,1,1,3,0,1,1,1,1,1,1,1,1,1,1,3,1,1,1,1,1,1,1,1,1],
    [0,0,0,0,0,0,3,0,0,0,0,0,0,3,0,0,0,0,3,0,0,0,0,0,0,0,0,0],
    [0,1,1,1,0,1,3,1,1,1,5,1,1,3,1,1,0,1,3,1,1,1,0,0,1,1,1,0],
    [0,0,4,4,4,4,3,0,0,0,0,0,0,3,0,0,0,0,3,0,0,4,4,4,4,0,0,0],
    [1,1,1,0,0,1,3,1,1,1,1,0,1,3,1,0,1,1,3,1,1,1,0,5,1,1,1,1],
    [0,0,0,0,0,0,3,0,0,0,0,0,0,3,0,0,0,0,3,0,0,0,0,0,0,0,0,0],
    [0,1,1,1,1,1,3,1,1,0,5,1,1,3,1,1,0,0,3,1,1,1,1,1,1,0,1,0],
    [0,0,0,0,0,0,3,0,0,0,0,0,0,3,0,0,0,0,3,0,0,5,0,0,0,0,0,0],
    [1,1,1,1,1,1,3,1,1,1,1,1,1,3,1,1,1,1,3,1,1,1,1,1,1,1,1,1],
    [0,0,0,0,5,0,3,0,0,5,0,0,0,3,0,0,5,0,3,0,0,0,0,0,0,0,0,0],
    [2,2,2,2,2,2,2,2,2,2,2,2,2,2,2,2,2,2,2,2,2,2,2,2,2,2,2,2]
  ],
  "player_spawn": {"col": 1, "row": 14},
  "enemy_spawns": [{"col": 26, "row": 0}],
  "escape_ladder_cols": [0]
}
